9
11
RR
XX       XX
XX       XX
     BBBBBB
  B       B
 BB SVBB  B
 BB BB    B
RBB BB  BB 
XX  BB  BXX
XX  BB  RXX