12
19
RGYOO
Y                 G
 PP P P P P P P PP 
 P               P 
                   
 P               P 
        VQ         
 P               P 
                   
 P               P 
                   
 PP P P PPP P P PP 
R       POP       O