9
11
RR
XXGGRGGGGXX
XXGGGGGGGXX
GG       GG
GG       GB
GG  QV   GG
GG       GG
YG       GG 
XXGGGGGGGXX
XXGGRGGGGXX